####################
#                  #
#                  #
#                  #
#                  #
#                  #
#                  #
#            #######
#            #######
#            #######
#                  #
#                  #
#                  #
#                  #
#                  #
#                  #
#    ###    ###    #
#    ###    ###    #
#    ###    ###    #
####################